1111111111111111
10000E0000P00001
10000CCC00000001
1111111111111111
